1111111111
1000000001
1E11111011
100C100011
1011100011
1C00100CP1
1111111111
