1111111111111111
1000000000000011
1C00000000000111
11111111111P0011
1000000000000011
1100000000000011
11C1111111111111
1100000000000011
1100000000000E11
1100000000000011
1111111111111111
